index;left;right
1;1 0 1 0 1 1;0 1 0 1 0 1;
2;1 0 1 1 1 0;1 1 0 0 0 1;
3;1 1 0 0 1 1 1;1 1 1 0 0 1 1;
4;0 1 1 1 0 1 0 1 0;1 1 1 0 0 1 1 1 1;
5;1 2 1 1 0 0 1 1 0 1;1 1 1 0 0 2 1 1 0 1;
6;0 2 1 0 1 0 1 0;2 0 1 1 1 0 0 1;
7;2 2 1 1 0 1 1 2 1 1;2 1 1 0 0 2 1 1 2 1;
8;1 1 1 2 2 1 1 1 1 1;1 2 1 1 1 1 2 2 1 1;
9;1 2 1 2 1 0 0 1 1 2;1 1 1 2 1 1 0 0 1 1;
10;2 2 1 2 1 1 1 0 0 1 2 1 1 1 1;1 1 1 2 1 1 0 0 2 2 2 1 1 2 1;